1111111111111111111111111111111111111111
1P00000000000001000000111100000000000001
1C00000000100000000C11100000000000000001
100000000000N0000000C0000000000000000001
100011110000000000000000000000000C000001
1000100100010000000C00000000000000000001
1000100000000N00000000000000000000000001
1000001000000000CCC000000000000000000001
10000000000000000000010010000000000000E1
10000000000C0000000110010001111110000001
1000000000000000000000000000000000000001
10000000C0000011111111000N00000000000001
10000000C0000000000000000111111000000001
100000000000000N000000000000000000000001
1000000000000000000000000000000000000001
100000C000100000000CC00C0000000000000001
1000111111000000000000000NNN000000000001
1000000C00000000000000000000000000000001
1000000000111000000000000000000000000001
1000000000000000000000000000000000000001
1111111111111111111111111111111111111111