1111111111111
1001000000011
1111111111001
1PEC111000001
1111111111111