1111111111111111111111111111111111
1E0000000000000C00000C000000000001
1010010100100000101001000000010101
1010010010101010NN10010000000101N1
1P0000000C00C0000N0000000000000NC1
1111111111111111111111111111111111